14 17
#################
#W-#.)######...)#
#--...##W#.#...W#
#.....##........#
##.)..#.).......#
####..-......)..#
####..-....###..#
###...-.....##..#
##....-.).=..#..#
#=....-...-..#b.#
##...........#==#
#----....#=-=#==#
#a.)####..-)-#==#
#################