5 5
#####
#W.)#
#=#W#
#..a#
#####
