14 17
#################
#w-#.)######...)#
#--...##w#.#...w#
#.....##........#
##.)..#.).......#
####..-......)..#
####..-....###..#
###...-.....##..#
##....-.).=..#..#
#=....-...-..#b.#
##...........#==#
#----....#=-=#==#
#a.)####c.-)-#==#
#################