7 8
########
#F.#..L#
#A....=#
#--==.)#
#).....#
#a..#.b#
########