15 17
#################
#c=)))=d#ab....w#
#..-)-..#.......#
#.......#.--.--.#
#...w...#.-)))-.#
#=.=.=.=#.-----.#
#w.....w#w.....w#
##=--=####-==-###
#.......#f......#
#.......=.......#
#...e...-...====#
#.......-...====#
#--...--=...==ww#
#)))))))#...==ww#
#################