7 8
########
#W.#..F#
#.....=#
#--==.)#
#).....#
#a..#.b#
########