7 8
########
#W.#...#
#.....=#
#--==.)#
#).....#
#a..#.b#
########