5 5
#####
#B..#
#=#A#
#..a#
#####
